28,28,28,28,12,28,28,12,28,12,12,12,12,12,12,12,12,28,12,12,12,28,12,12,12,12,12,12,28,12,28,12,12,28,28,12,28,12,12,28,12,12,12,12,28,12,28,12,28,12,12,12,12,12,28,28,12,12,12,12,28,28,12,12,12,28,28,12,28,12,28,28,28,12,28,12,28,12,28,12,28,28,28,12,12,12,12,28,12,28,28,28,28,12,12,28,12,28,12,12,12,28,28,12,12,12,12,28,28,28,12,12,28,28,28,12,28,12,12,28
28,12,28,12,12,12,28,28,12,28,12,12,12,28,28,12,12,28,28,12,28,12,12,28,12,28,12,12,28,12,12,12,28,28,28,28,28,28,28,28,28,12,12,28,12,28,28,28,28,28,28,28,12,12,12,12,28,28,28,28,28,28,12,12,12,28,28,28,12,12,28,12,28,28,12,28,28,28,12,12,12,12,12,12,28,12,12,12,12,28,28,12,28,12,28,12,28,28,12,12,28,28,12,28,12,28,12,12,12,28,28,12,12,12,12,28,28,12,28,12
12,12,28,28,28,12,12,28,12,28,28,28,12,28,12,12,28,12,28,28,28,28,12,12,12,28,12,28,12,28,28,12,28,28,12,28,12,12,12,28,12,28,28,12,28,12,28,28,28,12,12,28,28,28,28,12,12,12,12,28,28,28,12,28,12,12,12,28,28,12,12,28,12,12,28,12,12,12,12,12,12,28,28,12,12,28,28,12,28,12,28,12,12,12,28,12,12,28,12,28,28,28,12,28,12,28,12,12,12,28,28,12,28,12,12,12,12,12,28,12
28,12,28,12,12,28,28,28,28,28,28,12,12,12,28,12,12,28,28,28,12,12,12,12,12,28,12,12,28,12,28,12,28,28,28,28,12,12,12,28,28,12,12,28,28,12,12,28,28,28,12,28,12,28,28,12,28,28,28,28,12,12,28,28,28,12,28,28,28,28,28,28,28,12,12,12,12,28,12,28,12,28,28,12,28,28,12,28,12,12,28,12,12,12,12,28,28,12,28,28,12,12,12,28,12,12,28,28,28,28,12,28,12,28,12,28,12,28,12,12
28,28,12,12,12,28,12,28,28,12,12,12,12,28,12,12,12,12,28,12,28,12,28,28,12,28,12,28,12,28,12,12,28,28,28,28,12,28,28,28,28,12,12,12,12,28,28,28,12,12,28,12,28,12,28,28,28,28,12,12,28,28,12,12,28,12,28,12,12,28,12,28,28,28,12,28,28,12,12,12,28,28,28,28,12,12,28,12,12,12,12,12,28,28,28,12,28,28,28,12,12,12,12,28,28,12,28,12,28,28,12,12,12,12,28,12,12,12,28,12
28,12,28,12,12,12,28,12,12,28,28,28,12,12,28,28,12,28,28,12,12,12,12,28,12,28,28,28,28,28,12,28,28,12,12,12,28,28,12,28,12,12,12,12,28,12,28,12,28,12,28,12,28,28,28,12,12,28,12,12,28,28,12,28,28,28,12,28,12,28,12,28,28,28,28,12,12,12,12,28,12,28,28,28,28,12,12,12,12,12,12,12,28,12,28,28,12,28,28,12,12,28,28,12,12,28,28,12,28,12,28,12,28,12,12,28,28,12,28,12
28,12,28,12,12,12,28,28,12,28,12,12,12,28,28,12,12,28,28,28,28,28,12,28,12,12,12,28,28,12,28,28,28,12,28,28,12,28,12,12,28,12,12,12,12,28,28,12,28,28,12,12,12,12,12,12,12,28,12,12,12,12,12,12,12,12,12,28,12,12,28,12,28,28,12,28,12,28,12,28,28,12,28,12,28,12,28,28,28,28,12,12,28,28,12,28,28,28,12,28,12,28,28,28,12,12,12,12,28,12,28,28,28,28,12,12,12,28,12,12
12,28,12,12,28,12,28,28,28,12,12,12,28,12,12,12,12,28,12,12,12,12,12,28,28,12,28,12,12,12,28,12,12,28,12,12,28,28,12,12,12,12,28,28,28,12,12,12,12,28,12,12,28,12,28,12,12,28,28,28,12,28,28,12,28,28,12,28,12,12,12,28,12,12,12,28,12,12,12,12,12,28,28,12,28,12,12,12,12,28,28,12,28,28,12,12,12,12,28,28,12,28,12,28,12,12,12,28,28,28,28,12,28,28,12,28,12,12,28,12
28,12,28,12,12,28,12,28,12,28,28,28,12,28,12,12,28,28,28,28,28,28,12,12,12,12,28,12,12,12,28,28,12,12,28,12,28,12,12,28,28,28,28,12,12,12,12,12,12,28,12,12,12,28,12,28,12,28,28,28,28,28,12,12,28,28,28,28,28,28,12,28,12,12,28,28,28,28,12,28,28,28,28,28,28,12,28,28,28,12,12,12,12,28,12,12,12,28,28,28,12,12,28,12,12,12,12,28,12,12,12,28,28,12,28,28,12,28,28,28
12,12,28,28,28,12,28,28,28,12,28,28,12,12,12,12,28,28,12,12,12,12,12,28,12,12,28,28,12,12,28,12,28,12,28,12,12,12,12,28,28,12,28,12,12,12,12,28,12,12,12,12,28,12,12,12,12,12,28,28,12,12,12,28,12,12,12,28,28,28,12,28,28,12,28,28,28,12,28,28,12,12,12,28,28,28,28,12,28,12,12,28,28,28,12,12,12,12,28,28,12,12,12,28,12,28,28,12,12,12,28,12,12,12,28,12,12,28,12,28
28,12,28,12,12,28,28,28,12,12,28,12,12,28,12,28,28,28,12,28,28,28,12,28,28,28,12,28,28,12,28,28,28,12,12,12,12,12,28,28,28,28,12,12,28,12,12,12,12,12,12,12,28,28,28,12,28,28,12,28,28,28,28,12,28,12,28,12,28,12,12,12,12,28,28,28,12,12,12,12,28,28,12,12,12,28,12,12,12,28,28,28,28,12,12,12,28,28,28,28,28,12,12,28,28,28,12,28,28,12,12,12,12,12,28,12,28,28,12,28
12,12,12,28,12,28,28,28,28,28,28,28,28,12,12,28,28,12,28,12,28,28,28,28,12,28,12,12,28,28,12,28,28,12,28,12,12,12,12,28,28,12,12,28,12,28,12,28,12,12,12,12,28,12,12,12,28,12,28,28,12,12,28,28,12,28,12,12,28,28,12,12,28,12,12,28,12,28,28,28,28,12,12,28,12,28,12,28,12,28,12,12,28,28,28,12,28,12,28,12,28,12,28,28,28,28,28,12,12,28,28,28,12,12,12,28,28,12,12,28
12,12,12,28,28,28,28,12,28,12,28,28,12,28,12,12,28,28,28,28,12,12,28,12,12,12,28,12,28,12,12,12,28,28,12,28,12,12,28,28,12,28,28,12,12,12,12,12,12,28,28,28,12,12,28,12,28,28,28,28,12,28,28,12,28,28,12,28,12,12,12,28,28,28,12,28,12,12,28,28,28,12,28,12,12,12,28,28,12,28,12,12,12,28,28,12,12,28,28,28,12,12,12,12,12,28,12,12,12,12,28,12,12,28,28,28,12,12,28,28
28,28,28,12,28,28,12,28,12,28,12,12,28,28,12,12,12,12,12,28,12,12,12,12,28,28,28,28,12,28,12,28,12,28,12,12,12,12,12,12,12,12,12,28,28,28,12,12,28,12,12,12,12,12,12,28,12,28,28,28,12,28,12,12,12,28,28,28,28,28,28,28,28,28,12,12,28,28,12,28,28,28,12,12,28,12,28,28,12,12,28,12,12,12,28,12,28,28,12,28,28,12,28,12,28,28,12,12,28,28,12,12,12,28,12,12,28,28,12,28
28,12,28,28,12,28,28,12,28,12,28,28,12,28,28,12,28,28,28,12,28,28,28,28,12,12,12,28,28,28,28,28,28,28,12,28,12,28,28,12,12,28,12,12,12,12,28,12,12,28,28,12,12,12,28,28,28,12,12,12,12,28,28,12,12,12,28,28,12,12,28,28,12,28,12,28,12,12,28,12,12,28,12,12,28,12,12,12,28,12,28,28,28,28,28,28,12,28,28,28,12,28,12,12,28,12,28,28,28,28,12,28,28,12,12,12,28,12,12,12
28,28,28,28,12,12,28,28,12,28,28,12,28,12,28,28,12,28,28,28,28,28,28,28,12,12,12,12,12,12,12,12,12,12,28,28,28,12,28,12,28,12,12,12,28,28,28,12,12,12,28,12,12,12,28,12,12,28,12,12,12,28,12,12,28,12,12,12,28,12,28,28,28,12,28,12,28,12,28,12,12,28,28,28,12,28,12,28,28,28,12,12,28,12,28,28,12,28,12,28,12,12,28,12,28,28,28,12,28,28,12,12,12,28,12,12,12,12,12,12
28,28,12,12,12,28,28,12,28,28,12,28,28,28,12,28,12,12,12,28,12,12,28,28,12,28,12,28,12,28,12,28,12,12,12,12,12,12,28,12,12,28,28,12,12,12,28,12,12,28,28,12,28,28,12,28,12,12,12,12,28,12,12,12,12,28,28,28,12,28,28,12,28,28,28,28,12,12,12,28,12,28,28,12,28,28,28,28,28,28,28,28,28,28,12,28,28,12,12,28,28,12,12,12,28,28,12,12,12,28,12,12,28,28,28,12,28,12,28,28
12,28,28,28,28,28,28,28,12,28,28,12,12,12,12,12,28,28,12,12,28,28,12,12,12,28,12,12,12,12,28,28,28,28,12,12,28,12,12,12,28,28,12,12,12,12,12,12,12,12,12,12,28,12,12,12,28,12,12,28,12,12,12,28,28,12,28,12,12,28,12,12,12,28,12,28,28,28,12,12,12,28,12,28,12,28,12,12,28,12,28,12,28,12,12,12,12,12,12,28,12,28,28,28,12,28,28,28,28,28,12,28,12,12,28,28,28,12,28,12
28,12,12,28,12,12,28,28,28,28,12,28,28,28,12,12,12,12,28,28,12,28,28,28,28,12,28,12,28,12,12,12,28,12,12,28,12,12,12,28,12,12,12,12,28,12,28,12,28,12,28,12,12,12,12,12,28,12,12,12,12,12,12,28,12,28,12,12,12,28,28,12,12,12,12,28,12,12,12,28,28,28,28,12,12,12,12,28,28,12,12,28,28,12,28,28,28,28,28,28,28,12,28,12,12,28,28,12,12,12,28,28,28,28,28,28,28,28,12,28
28,28,12,28,28,12,12,28,28,28,28,28,28,28,28,12,12,28,28,28,12,12,12,12,28,28,12,12,28,28,12,12,28,28,28,12,12,12,12,12,28,12,28,12,12,12,28,12,12,12,28,12,12,28,12,12,12,12,12,12,28,12,28,28,28,28,12,12,28,12,28,12,28,12,12,12,28,28,28,12,28,12,28,12,12,28,12,12,12,28,12,12,12,12,12,12,28,28,28,28,28,12,28,12,28,12,12,12,28,12,12,12,28,12,12,12,28,28,28,28
28,28,12,28,12,28,28,12,28,28,28,28,12,28,28,12,12,28,12,12,28,12,28,28,12,28,28,12,28,28,12,12,12,12,12,12,12,12,28,12,28,28,28,12,28,12,28,12,12,12,12,12,12,28,12,12,12,28,12,12,12,28,12,28,28,28,28,12,12,12,12,28,28,28,12,12,12,12,28,28,28,12,28,28,28,12,12,28,12,28,28,28,12,28,28,28,12,12,28,12,12,28,28,28,28,28,12,28,12,12,28,28,12,12,12,12,12,28,28,28
12,12,28,28,28,28,12,12,28,12,28,28,28,28,12,28,28,12,28,12,28,28,28,12,12,12,12,12,12,12,28,28,12,28,12,12,28,28,12,28,28,12,12,12,12,12,28,12,12,12,12,28,12,12,12,12,12,12,12,12,12,28,12,28,12,28,12,28,12,28,28,12,12,12,12,28,12,12,28,28,12,12,12,12,12,28,28,28,12,12,28,12,28,12,28,12,28,12,28,28,12,28,28,28,28,28,28,28,12,28,28,12,28,12,28,12,28,28,28,28
28,12,12,12,12,28,12,12,12,28,28,28,28,12,28,28,12,12,12,28,28,28,28,28,28,12,12,12,28,28,12,28,12,12,12,28,12,12,28,12,28,28,12,12,12,12,12,12,12,12,28,12,28,12,12,28,12,12,12,28,12,28,12,28,28,28,12,12,28,12,12,12,12,12,12,28,12,12,12,28,28,28,28,28,28,12,12,28,12,28,28,28,12,28,28,12,12,28,12,28,28,12,12,28,28,12,12,28,12,28,12,28,12,28,12,28,28,28,12,12
28,28,12,12,28,12,12,28,12,12,28,28,12,12,28,28,28,28,28,28,12,28,28,12,12,12,12,12,12,28,28,28,28,12,28,28,12,12,28,12,28,12,12,12,12,28,12,12,28,12,12,28,12,12,12,28,12,28,28,12,28,12,28,28,12,28,28,28,12,28,28,28,28,12,12,12,12,28,28,12,12,28,28,28,28,12,28,12,12,12,12,12,28,28,12,12,12,28,28,12,28,28,28,28,12,12,12,12,28,28,12,28,12,12,28,12,28,12,28,28
12,28,12,12,12,12,12,12,12,28,28,12,12,12,28,12,28,28,28,28,12,12,12,28,28,28,28,28,12,12,12,28,12,12,12,28,12,28,12,28,12,12,12,28,28,12,28,28,12,28,12,12,12,28,12,12,28,12,28,12,12,12,28,28,12,28,12,28,12,28,28,28,12,28,28,28,12,28,28,12,12,28,12,12,28,28,12,12,28,28,12,12,12,12,28,12,12,12,12,12,28,12,28,28,28,28,12,28,28,28,12,28,28,12,28,12,12,28,12,12
12,12,28,28,28,12,28,28,28,12,12,28,12,12,12,28,12,12,28,28,28,12,12,28,28,12,12,28,28,28,28,12,28,12,12,12,28,28,28,28,12,12,12,12,28,12,28,28,28,12,12,28,12,12,28,12,28,12,12,12,28,12,12,12,28,28,28,12,28,28,12,12,12,28,28,12,12,28,12,28,12,28,12,12,12,12,12,12,12,12,28,28,28,12,12,28,12,28,28,12,28,28,12,12,28,28,28,12,12,28,12,28,12,12,12,28,28,28,12,28
12,28,12,12,12,12,12,12,28,12,28,12,12,12,28,12,12,12,12,12,12,28,12,28,12,28,12,28,12,12,12,12,28,12,12,12,28,12,28,12,12,12,12,28,12,28,12,12,12,12,12,28,28,12,12,12,12,12,12,12,12,28,12,12,12,12,28,28,12,12,28,28,12,28,28,28,28,28,12,28,28,12,12,28,12,12,12,12,28,28,28,28,28,28,28,28,28,28,28,12,28,12,28,28,28,12,28,12,12,28,12,28,28,12,28,12,12,28,12,12
12,28,28,28,12,12,28,12,12,12,12,28,28,12,12,28,28,12,12,28,28,28,28,12,28,12,12,28,12,28,28,12,12,28,12,28,12,28,28,28,12,12,12,12,28,12,28,28,12,12,12,12,12,12,28,12,28,28,28,12,12,28,12,12,12,28,12,12,12,12,28,28,28,12,28,12,28,28,28,12,12,28,28,12,12,12,28,12,28,28,12,28,28,12,28,28,28,12,12,12,28,28,12,28,28,28,28,28,12,28,28,12,12,12,28,28,28,12,28,28
12,12,12,28,12,12,28,28,28,12,28,28,28,12,28,28,28,28,12,28,28,28,12,28,28,28,12,12,28,28,12,12,12,28,12,12,28,12,28,28,12,12,12,12,28,12,28,28,28,28,12,28,12,28,12,12,12,28,12,12,28,28,28,12,12,28,12,12,28,28,12,28,28,12,12,28,28,28,12,12,12,28,28,12,28,12,12,28,12,12,12,28,12,12,28,12,28,12,12,28,12,28,28,28,12,12,28,12,12,12,12,12,12,12,28,28,12,28,28,28
12,28,28,12,12,12,28,28,28,28,12,28,28,28,12,28,12,28,28,28,28,28,28,12,28,12,12,12,28,12,28,12,12,12,28,12,28,12,28,12,12,12,28,12,28,28,12,12,12,12,12,12,12,28,12,12,12,12,12,28,12,12,12,28,28,12,28,28,12,28,28,12,28,28,28,12,12,12,12,12,28,28,12,12,12,12,28,28,12,12,28,28,12,12,28,28,12,28,12,12,12,28,28,12,28,12,28,28,28,28,28,12,12,28,12,28,28,12,12,12
28,12,12,12,12,12,28,12,28,12,28,12,28,12,12,28,28,12,12,12,28,12,12,28,28,12,28,28,12,12,28,28,28,12,12,12,12,28,28,12,28,28,12,12,28,12,12,12,28,28,28,12,12,12,12,12,12,12,28,12,28,28,12,12,12,12,28,28,28,28,28,12,28,12,12,12,28,28,12,12,12,12,28,28,12,12,12,28,28,12,28,28,28,12,28,12,28,28,28,28,28,28,12,12,28,12,28,28,28,12,12,28,28,12,12,12,28,28,28,12
12,12,12,12,12,28,28,12,28,12,28,12,12,12,12,28,28,28,12,28,12,12,12,28,28,12,12,28,28,12,28,12,12,28,12,12,28,12,12,12,12,28,28,12,12,28,12,28,12,12,28,28,12,12,12,12,28,28,12,28,12,28,28,28,12,12,12,12,28,28,28,28,12,28,12,28,12,12,28,28,28,12,12,12,28,28,12,28,12,12,12,28,28,28,12,28,28,12,28,12,28,12,28,28,28,12,28,28,28,12,28,28,12,28,12,12,28,12,12,28
12,12,28,12,28,12,12,28,28,28,28,12,12,28,12,12,12,12,12,12,12,28,12,12,28,28,28,12,28,28,28,12,28,12,12,12,12,28,12,12,28,28,12,28,12,12,28,12,28,12,12,12,12,12,28,28,12,12,12,12,12,12,12,12,28,12,28,12,12,28,28,12,28,12,28,28,28,12,12,12,28,12,12,28,12,12,28,28,28,12,28,12,12,28,12,28,28,28,12,28,28,12,12,28,28,12,28,28,12,28,12,12,12,28,28,12,28,12,28,12
28,28,28,12,12,12,28,12,28,12,12,28,12,12,12,28,12,12,28,28,12,28,12,12,28,12,12,28,12,28,28,12,12,28,12,12,12,12,12,28,12,12,12,12,12,12,12,28,12,12,12,12,28,28,12,28,28,12,28,12,12,28,12,12,28,12,28,12,12,28,12,28,28,28,12,28,28,28,28,12,28,28,12,12,12,12,12,28,12,12,12,28,12,28,12,12,28,12,12,28,12,28,12,28,28,28,12,12,28,28,28,28,12,28,28,12,12,28,28,28
28,28,12,28,28,28,28,28,12,28,12,12,12,12,28,28,28,28,12,12,12,12,12,28,28,12,12,28,12,28,28,28,28,12,28,28,12,12,12,12,28,12,12,12,12,12,28,12,28,12,28,12,12,12,12,12,12,12,28,12,28,12,28,12,12,12,28,28,12,28,28,28,12,28,12,28,28,28,12,12,28,12,12,28,12,12,12,12,28,12,12,28,12,12,12,12,12,28,12,28,12,28,28,28,12,28,12,28,28,12,12,12,12,28,12,28,28,28,28,28
28,28,28,28,12,28,28,12,12,12,12,12,28,12,12,12,28,28,28,28,28,12,12,12,28,28,12,12,28,28,28,28,28,28,12,28,12,12,12,12,12,28,28,12,12,12,28,12,12,12,12,12,12,12,12,28,12,12,12,12,12,12,12,28,12,12,12,12,12,12,28,12,12,12,12,12,28,28,28,28,28,28,28,12,28,12,28,28,12,28,28,28,28,12,28,12,28,28,28,28,12,28,28,12,28,12,12,28,28,12,28,12,28,28,12,12,28,28,28,28
12,12,12,28,28,28,12,12,12,12,28,28,28,28,12,12,12,28,28,28,28,28,12,28,12,28,12,28,28,28,12,28,28,28,12,12,28,12,28,12,12,12,12,12,12,12,28,12,28,12,12,28,12,12,12,12,12,12,12,28,12,28,12,28,12,28,12,12,28,28,28,12,12,12,12,28,28,12,12,28,12,12,28,28,28,28,12,28,12,28,12,28,12,12,28,28,12,28,12,28,28,28,12,12,12,28,12,28,28,28,28,12,28,28,28,28,28,12,28,28
28,12,28,28,28,28,12,12,28,28,12,12,28,28,28,12,28,12,28,28,28,12,28,28,12,12,28,28,28,28,12,28,28,12,28,28,28,28,12,28,12,12,12,12,12,28,28,12,12,28,12,12,28,12,12,12,12,28,12,28,12,28,28,12,12,12,28,28,28,28,12,12,12,12,12,12,28,12,12,28,28,12,28,12,28,12,28,28,28,12,12,28,28,28,28,28,12,28,28,12,28,28,12,28,28,28,28,28,28,12,28,12,12,12,28,28,28,28,12,28
12,12,28,28,28,12,28,28,12,12,12,28,12,28,28,28,12,12,12,12,28,28,28,12,28,28,28,28,28,28,28,12,12,28,28,28,12,12,12,12,12,12,12,12,28,28,28,28,12,12,28,12,28,12,12,12,12,12,28,12,12,12,12,12,12,12,12,28,12,28,12,28,28,28,12,28,28,12,12,12,12,12,12,12,28,28,12,28,12,12,12,28,28,28,28,12,28,12,28,28,28,28,12,12,12,12,28,12,12,28,28,12,28,28,28,28,12,28,28,12
12,12,28,12,12,28,12,12,28,12,28,28,12,28,28,28,12,12,12,12,28,28,28,12,12,28,12,28,12,28,28,28,12,28,28,12,28,28,28,12,28,28,12,12,12,12,28,12,28,12,12,12,12,28,28,28,12,12,12,12,28,12,28,12,28,28,12,12,12,28,28,12,28,28,28,28,28,28,12,28,12,12,28,12,12,28,12,12,28,28,12,28,12,28,28,12,28,12,12,28,28,12,28,28,28,28,12,12,12,28,28,12,28,28,12,12,12,12,12,12
12,12,12,12,28,28,28,28,12,12,28,12,12,28,28,28,12,28,12,12,12,28,28,28,12,12,12,12,28,28,28,28,12,28,28,28,12,12,28,12,12,12,12,12,12,28,12,28,12,12,28,28,28,12,12,12,28,12,28,12,12,12,12,12,12,12,12,12,12,28,28,12,12,12,28,12,28,12,28,12,28,28,12,12,28,28,12,12,12,28,12,12,28,28,12,28,12,12,28,28,28,28,28,28,12,12,28,28,12,28,28,12,28,28,28,12,28,28,28,12
12,28,12,28,28,12,12,28,28,28,28,12,12,12,12,12,28,12,12,28,12,28,28,28,28,28,12,12,12,28,12,12,12,28,12,28,12,12,12,12,12,12,12,12,12,12,28,12,12,12,12,12,28,12,28,12,12,28,12,12,12,28,12,12,28,12,28,28,28,28,12,12,28,28,28,28,28,12,28,28,28,28,12,28,12,12,12,12,12,28,28,28,12,28,28,12,12,28,12,28,28,12,12,12,28,12,28,28,28,28,28,12,28,12,12,12,12,28,28,28
28,28,12,12,12,12,28,12,12,28,28,12,12,28,28,12,28,28,12,12,28,28,28,12,28,28,28,12,28,12,28,28,12,28,12,12,12,12,28,12,12,12,28,12,12,28,28,12,12,28,12,28,28,12,12,28,28,28,28,28,12,12,12,12,28,28,12,12,28,12,12,12,12,12,12,28,28,12,12,28,12,12,28,12,12,28,28,12,12,28,12,28,28,12,12,12,12,12,28,12,28,12,28,28,28,28,28,12,28,12,28,28,28,12,28,12,12,12,12,28
28,28,28,12,12,12,28,12,12,12,28,12,28,12,12,28,28,28,28,28,12,28,28,12,28,28,28,12,12,28,12,28,12,12,28,12,28,28,28,12,12,12,12,28,12,12,12,28,12,12,12,28,12,28,12,12,12,12,28,12,12,28,12,28,12,28,12,12,12,28,12,28,12,12,28,28,12,28,28,28,28,12,12,12,28,28,12,28,28,28,28,12,12,12,28,28,28,12,28,12,12,28,12,12,12,28,28,12,12,28,12,12,12,28,28,28,28,28,28,12
12,12,12,12,28,28,12,12,28,28,28,12,28,28,12,12,12,12,12,12,28,12,28,28,12,12,28,12,28,28,12,12,28,12,12,28,28,12,12,28,12,12,12,28,28,28,12,12,12,12,12,28,28,12,28,28,28,28,28,12,28,28,28,12,28,12,28,12,12,28,12,28,12,28,28,28,12,12,12,28,12,28,12,12,28,28,12,28,12,12,12,12,28,28,28,12,28,28,12,28,12,12,28,28,12,12,28,12,28,28,12,28,12,12,12,12,12,12,12,12
12,12,28,12,12,12,12,12,12,12,28,12,12,28,12,12,12,12,12,28,28,12,28,28,28,28,12,28,28,12,28,28,12,28,28,12,28,12,12,28,12,12,28,12,12,28,28,28,28,12,28,12,28,28,12,28,12,28,12,28,28,28,28,12,28,28,28,28,28,12,28,12,12,12,12,12,28,12,12,28,12,28,28,12,28,12,28,12,12,12,12,28,12,12,12,28,12,28,12,28,12,28,12,12,28,28,28,28,28,28,12,28,28,12,28,12,28,12,12,28
28,28,12,28,12,28,12,12,28,12,12,12,12,28,28,28,28,28,12,28,28,12,12,28,28,28,28,28,12,12,28,12,12,28,28,12,28,28,28,12,12,12,12,28,28,28,12,28,12,28,28,12,12,28,28,12,12,28,28,28,12,12,12,28,28,28,12,12,28,28,28,12,12,12,28,12,28,12,28,28,12,12,28,12,12,12,12,12,12,28,28,12,12,12,12,28,12,12,28,12,28,28,12,28,12,28,12,28,28,28,12,28,28,12,12,28,28,12,28,28
28,12,12,12,28,28,28,28,12,12,12,28,12,28,12,28,12,28,28,12,12,28,28,28,12,12,28,12,12,28,12,12,12,12,28,12,12,28,28,12,12,12,28,28,28,28,28,28,12,12,12,12,12,12,12,28,12,28,12,28,12,12,28,12,12,28,28,12,28,12,28,28,12,12,28,12,12,12,28,28,12,28,12,12,28,12,28,28,28,28,12,28,28,28,12,28,12,12,28,12,28,12,28,12,12,12,28,28,28,12,12,28,28,28,12,12,12,12,28,28
28,12,12,28,12,12,28,28,28,28,28,12,12,12,12,28,28,12,28,12,12,12,28,12,28,12,12,12,28,28,28,28,12,28,28,28,28,12,12,28,28,12,12,28,12,12,12,12,12,12,12,12,12,12,28,12,12,12,28,28,28,28,12,28,28,12,12,12,28,12,12,28,12,12,28,12,12,12,28,12,12,28,12,12,12,28,12,12,12,28,12,12,12,12,28,12,12,28,12,12,28,12,12,28,28,12,12,12,12,28,28,12,28,12,12,28,28,12,12,28
12,12,28,28,12,28,28,28,28,12,28,28,12,12,12,12,28,28,12,12,28,28,28,12,12,28,28,12,28,28,12,28,28,12,28,28,28,12,28,28,28,28,28,28,12,12,28,12,28,28,12,28,28,12,12,12,12,12,12,28,12,28,28,12,28,12,12,12,12,28,12,28,28,12,12,12,12,12,28,12,28,12,12,12,28,12,12,28,12,12,12,12,28,12,12,12,12,12,28,12,12,28,28,12,12,12,12,28,28,12,12,12,28,28,12,12,28,28,12,12
12,12,12,28,12,12,28,12,28,12,12,28,12,28,12,28,12,28,12,12,28,28,28,28,12,12,28,12,12,12,12,28,28,28,28,28,28,28,12,28,28,12,12,28,28,12,28,12,12,28,12,28,12,28,28,28,12,28,28,12,28,28,28,28,28,12,12,12,28,12,28,28,28,12,12,12,28,28,28,28,12,12,12,12,28,12,12,12,12,28,28,12,28,12,28,12,28,28,12,12,12,28,12,12,28,12,28,12,12,12,28,12,28,28,28,28,28,12,12,28
12,12,28,28,28,28,28,28,12,12,12,28,28,28,28,28,28,12,28,12,28,28,12,12,12,28,28,28,28,12,12,12,12,12,28,12,12,28,12,28,12,28,28,28,28,12,28,12,12,12,28,12,12,28,12,12,28,12,28,12,12,28,12,28,28,28,28,12,12,28,12,12,28,12,28,28,28,12,28,28,12,12,12,12,28,28,28,28,28,28,12,12,28,12,12,28,28,12,28,12,28,12,28,28,12,28,12,28,28,12,12,12,28,12,28,28,28,12,28,28
28,28,12,28,12,12,12,28,28,28,28,12,28,28,12,28,12,28,28,28,12,28,12,12,28,28,12,12,28,12,12,12,28,28,12,12,28,12,28,28,12,12,28,12,12,28,12,12,28,12,12,28,28,12,28,12,12,28,28,28,12,12,12,28,28,28,28,28,12,12,28,28,28,12,12,12,28,28,28,28,28,12,12,28,28,12,28,28,12,12,28,28,12,12,12,28,28,12,12,12,12,12,28,28,28,28,28,12,12,12,12,28,12,28,12,28,28,28,12,28
12,28,12,28,28,12,28,12,12,12,12,28,28,28,12,12,28,12,28,28,28,12,28,28,28,12,12,12,12,28,28,12,12,12,12,12,12,12,12,28,12,28,12,28,28,12,28,28,28,28,28,12,28,28,28,28,12,12,28,12,12,12,12,12,12,28,28,12,28,12,12,28,28,12,12,28,28,28,12,28,28,12,12,28,12,28,12,12,12,12,28,12,28,28,28,28,28,12,12,12,28,28,28,12,28,12,12,28,12,28,28,12,28,28,28,28,28,12,12,28
28,28,12,12,12,12,12,28,12,12,28,28,12,12,12,28,28,28,28,12,12,28,12,28,28,12,12,12,28,12,28,12,12,12,28,28,28,12,28,12,28,12,12,28,12,12,12,12,12,12,12,28,12,28,12,12,12,28,28,28,12,12,28,28,12,12,28,12,12,28,28,28,12,28,28,12,28,12,12,28,12,12,28,12,12,12,28,28,28,12,28,28,12,28,28,12,12,12,12,28,28,28,28,12,28,28,28,28,12,28,12,28,28,28,28,12,28,28,12,28
28,28,12,12,28,12,12,28,28,28,28,28,12,12,28,12,28,28,28,28,28,12,12,28,28,28,12,28,28,12,12,28,28,12,12,28,28,12,28,28,12,28,28,28,28,12,28,12,28,28,12,12,28,12,28,28,28,12,28,28,28,12,12,12,28,12,12,28,28,28,12,12,12,12,12,12,28,12,12,12,12,12,28,28,12,28,28,12,28,12,12,12,28,28,12,12,28,28,28,12,12,28,28,28,12,12,12,28,12,28,12,12,28,12,12,12,28,28,28,12
28,28,12,28,28,28,12,28,28,12,12,12,12,12,12,28,12,12,28,12,28,12,12,28,12,12,12,12,12,12,28,28,28,12,12,12,12,12,12,12,12,28,28,12,12,12,28,28,28,12,12,28,12,28,28,28,28,28,28,28,28,12,28,28,28,12,28,12,12,12,28,28,28,12,12,28,12,12,28,28,12,12,28,12,12,28,12,28,12,28,28,12,12,28,12,12,12,28,28,28,28,28,12,12,28,12,12,12,28,28,28,12,12,12,28,12,28,28,12,28
12,28,28,12,12,12,12,12,12,28,12,28,12,28,28,28,28,28,12,12,12,28,28,28,28,12,28,28,12,12,12,12,12,28,12,12,12,12,28,28,12,28,12,12,12,12,28,28,28,28,28,12,12,12,28,12,28,28,28,28,28,28,28,28,28,28,28,12,28,12,12,12,12,12,28,28,28,12,28,28,12,28,28,28,28,28,28,28,12,28,12,28,28,28,12,28,12,12,12,12,12,12,28,12,12,12,28,28,28,28,28,12,12,12,28,28,28,28,12,28
28,28,12,28,12,28,28,12,12,28,12,12,28,12,28,28,28,28,12,28,28,28,28,12,12,12,28,28,12,12,12,12,12,28,28,28,28,28,28,28,28,28,28,12,12,12,12,28,12,28,12,12,12,28,28,12,12,28,28,28,28,28,28,12,28,12,12,12,12,28,12,12,12,12,12,28,12,12,12,28,28,28,12,12,12,12,12,12,28,28,12,12,28,28,12,28,12,12,12,28,28,28,12,12,12,28,12,28,28,28,28,12,28,28,28,28,28,28,28,28
28,28,28,28,28,12,28,12,28,12,28,28,12,12,28,28,12,12,28,28,28,28,28,28,12,28,28,28,28,28,28,12,28,28,28,28,28,28,28,28,28,28,12,12,12,28,12,28,12,28,28,28,12,12,28,28,28,28,12,28,28,28,12,28,12,12,28,12,28,12,12,12,12,28,28,12,28,12,28,12,28,12,28,12,12,28,28,28,28,12,12,12,28,28,28,28,12,12,28,12,12,28,28,28,28,28,12,12,12,28,28,28,12,12,28,12,28,12,12,12
28,28,12,12,12,28,28,28,12,28,28,12,28,28,12,12,28,28,28,28,28,28,28,28,12,28,12,12,28,28,28,28,28,12,12,28,12,12,12,12,28,28,28,12,28,28,12,28,28,28,28,12,12,28,12,28,12,12,28,28,12,12,28,12,12,12,28,28,28,12,12,12,28,12,12,28,12,12,28,12,12,12,12,28,28,28,28,28,28,28,12,12,28,12,28,28,28,28,28,12,12,12,28,12,28,12,12,12,28,28,28,12,28,12,12,28,28,28,12,12
12,12,12,28,12,28,12,28,12,12,28,12,12,28,12,12,12,12,12,28,12,12,12,28,12,28,28,28,12,28,12,12,28,28,12,28,28,12,28,12,12,28,28,12,28,12,12,12,28,12,28,12,12,28,12,12,28,12,28,12,12,28,28,28,28,12,28,12,12,12,12,28,12,12,28,28,12,28,12,28,28,12,28,12,28,28,28,28,28,12,28,28,12,28,28,12,12,12,12,12,12,28,28,28,12,28,12,12,28,28,28,28,12,28,28,28,28,12,28,28
12,28,12,28,12,28,28,12,28,28,28,12,28,28,12,28,28,12,28,28,12,12,28,28,12,12,12,12,28,12,12,28,12,28,12,12,12,12,28,28,12,12,12,12,28,28,12,28,28,12,12,12,28,12,12,28,28,28,12,12,12,28,12,28,28,28,28,28,28,28,28,12,12,28,12,12,28,12,12,28,12,12,12,12,28,28,12,28,28,28,12,28,12,12,28,28,28,28,28,12,12,28,12,28,12,28,12,28,12,12,28,12,12,28,12,12,12,28,12,12
12,28,12,28,28,12,28,12,12,28,12,12,28,12,28,28,12,12,28,28,12,28,12,28,12,28,28,12,28,12,12,12,28,28,28,28,12,28,12,28,28,28,12,28,28,28,12,12,12,28,12,28,28,12,12,12,12,28,12,28,12,28,28,12,28,12,12,12,12,12,28,28,12,12,12,12,12,12,28,12,28,12,28,28,12,28,28,28,28,28,28,12,28,28,28,28,28,12,12,28,12,28,28,12,12,28,28,28,12,28,12,12,28,28,12,28,28,12,28,12
28,28,12,12,28,12,12,28,12,12,28,12,12,12,12,28,28,28,12,12,28,12,12,28,28,12,12,28,28,28,12,12,28,28,12,12,28,28,28,12,12,12,12,12,12,12,12,28,28,28,28,12,28,28,12,12,12,28,28,12,28,28,28,28,12,28,12,12,28,28,12,12,12,12,28,28,12,28,12,28,28,12,28,28,28,28,12,28,28,28,12,28,12,28,12,12,28,28,28,28,12,12,12,12,28,28,12,28,28,12,28,12,28,12,12,28,12,28,28,12
28,12,28,28,28,28,28,28,12,12,12,28,12,28,28,12,12,28,12,12,12,28,12,28,12,28,28,12,28,12,28,28,12,12,12,28,28,12,28,28,12,28,28,28,28,28,12,12,12,28,12,12,28,12,12,12,12,12,12,28,12,28,12,12,12,28,28,12,28,12,12,28,12,12,28,28,28,12,28,12,12,28,12,28,12,28,12,12,12,28,28,12,12,28,12,12,28,28,12,28,12,12,12,28,28,28,12,28,12,12,12,12,12,28,12,28,28,28,12,12
12,28,12,12,12,12,28,28,12,28,12,28,28,28,12,12,12,28,12,12,12,12,28,12,12,12,12,12,28,28,28,28,28,12,28,12,12,12,28,12,28,12,28,12,12,28,12,28,12,28,28,28,12,12,12,12,12,12,12,28,28,28,28,12,28,28,12,28,12,28,28,28,12,12,12,12,28,12,28,28,12,12,28,28,28,28,12,28,28,28,12,28,28,12,28,12,12,12,12,12,28,12,28,28,12,28,12,12,12,12,12,12,12,12,12,28,28,28,28,12
12,28,28,12,12,28,28,28,12,28,28,28,12,12,28,12,12,12,12,28,12,28,12,28,28,12,12,12,28,12,28,28,28,12,28,28,12,12,12,12,28,12,28,12,28,12,12,12,12,12,12,28,28,28,12,28,12,28,28,28,28,28,12,12,12,12,12,28,28,28,28,28,28,28,12,12,28,28,28,28,28,12,12,12,28,12,28,28,28,12,28,28,12,28,12,12,28,12,28,12,28,28,28,12,12,28,12,12,12,12,28,28,28,12,12,12,28,12,12,12
